2 5 0 3 1 1
+-+-+-+-+-+
|   |     |
+-+-+ + +-+
|     |   |
+-+-+-+-+-+